R 800 400
NO ./textures/wood.xpm
SO ./textures/wall_1.xpm


WE ./textures/eagle.xpm
EA ./textures/wall_4.xpm

S ./textures/barrel.xpm
F 245,162,93
C 1, 197, 196


1111111111111 11111111111111
1000000000111 10000000001  
1011000001111110000020001
10010000000000000N0000001
111111111011000001110000111111111
100000001111000001110111111111111
111101111 1111011101110010001
111101111 1111011101 10010001
11000000111101011101 10010001
10002000000000001101110010001
10000000000000001101010010001
1100000111010101111101111010111
11110111 1110101 101111010001
11110111 1110101 101111010001
11110111 1110101 101111010001
11111111 1112111 111111111111
           111