R 1080 720
NO ./textures/wall_4.xpm
SO ./textures/wall_2.xpm
EA ./textures/ wall_1.xpm
WE ./textures/wood.xpm
S ./textures/barrel.xpm
C 255,200,160
F 122,122,122

11111111111111111
10000000000000001
10200000200000201
10000000000000001
10002000000100001
10000000001000001
10202020N02020201
10000000000000001
10002000200200001
10000000000000001
10200000200002001
10000000000000001
11111111111111111