R 1080 720
NO ./textures/wall_1.xpm
SO ./textures/wall_2.xpm


WE ./textures/wall_3.xpm
EA ./textures/wall_4.xpm

S ./textures/barrel.xpm
F 7,133,34
C 52,213, 34



        1111111111111111111111111
        1000000000110000000000001
        1011000001110000002000001
        10010000000000N0000000001
111111111011000001110000000000001
100000000011000001110111111111111
11110111111111011100000010001
11110111111111011101010010001
11000000110101011100000010001
10000000000000001100000010001
10000000000000001101010010001
110000011101010111110111100111
11110111 1110101 101111010001
11111111 1111111 111111111111